7 17
|---------------|
|P.F-...P...-F.P|
|.-...--F--...-.|
|F..-.|F.F|.-..F|
|.--P--.-.--P--.|
|P......@......P|
|---------------|
