7 17
|---------------|
|P..-.......-..P|
|.-...--F--...-.|
|...-P|F.F|P-...|
|.--..-----..--.|
|P......@......P|
|---------------|
