7 17
|---------------|
|P..-.......-..P|
|.-...--F--...-.|
|F..-P|F.F|P-..F|
|.--.----.--.--.|
|P......@......P|
|---------------|
